DENTISTA,Aldeota,Bezerra,Centro,Conjunto Ceará,Maracanaú,Messejana,Parangaba,Total
Italo Castelo,10,13,2,0,0,0,12,37
Monatha,5,0,0,0,0,0,14,19
Gabriela,1,0,0,0,0,0,9,10
Allyne Fontenele,1,0,4,1,0,2,0,8
Marina,0,0,0,0,0,6,0,6
Jessey,0,0,0,0,0,5,0,5
Lilian Cibele,0,3,0,0,1,0,1,5
Carlos Antonio Veraz,0,0,0,2,0,0,2,4
Carlos Eduardo,0,1,0,0,0,1,2,4
Joana,0,0,4,0,0,0,0,4
